5
7 6
1 1 1 1 1 4
1 0 0 0 1 4
1 3 3 3 1 4
1 2 2 2 1 1
1 0 0 0 0 1
1 0 0 0 0 1
1 1 1 1 1 1
9 7
1 1 1 1 4 4 4
1 3 0 1 1 4 4
1 3 0 0 1 4 4
1 3 0 2 1 4 4
1 1 2 0 1 1 1
4 1 0 2 0 0 1
4 1 0 0 0 0 1
4 1 0 0 1 1 1
4 1 1 1 1 4 4
6 8
1 1 1 1 1 1 1 1
1 3 0 0 0 0 0 1
1 0 3 2 2 2 0 1
1 3 0 0 0 0 0 1
1 1 1 1 1 0 0 1
4 4 4 4 1 1 1 1
8 7
1 1 1 1 1 1 1
1 0 0 0 0 0 1
1 0 3 2 3 0 1
1 0 2 3 2 0 1
1 0 3 2 3 0 1
1 0 2 3 2 0 1
1 0 0 0 0 0 1
1 1 1 1 1 1 1
8 10
4 1 1 1 1 4 4 4 4 4
4 1 0 0 1 1 1 1 4 4
4 1 0 0 0 0 0 1 1 4
1 1 0 1 1 0 0 0 1 4
1 3 0 3 1 0 0 2 1 1
1 0 0 0 1 0 2 2 0 1
1 0 0 3 1 0 0 0 0 1
1 1 1 1 1 1 1 1 1 1
